버리다|포기하다|폐기하다|유기하다|떠나다
절대적인|완전한|정말|가장 …한|확실한
용서하다|면제하다|사면하다
삼가다|절제하다|끊다
받아들이다|수용하다|인정하다|입학시키다|응하다
접근할 수 있는|사용하기 쉬운|이용 가능한
수용하다|맞추다|편의를 도모하다
적응하다|변화|적용|각색하다|익숙해지다
숙련된|숙련자|숙달된
고수하다|들러붙다|달라붙다
틀림없이|널리 인정되고 있는 것처럼|확실히
채택하다|입양하다|도입하다|취하다|적용하다
출현|도래|등장|대림절|일어남
우발적인|부정의|외래의
모험을 좋아하는|대담한|위험이 많은
부정적인|반대의|불리한
역경|재난|불운
영향을 주다|작용하다|감염시키다|…체하다
관계|소속|협력|관련|제휴
확인하다|확언하다|긍정하다
여유가 있다|할 수 있다
기관|소속사|대행|에이전시|대리점
의제|과제|안건|아젠다|정책
민첩한|명민한|기민한
선동하다|흥분시키다|휘젓다
주장하다|진술하다|단언하다
할당하다|배분하다|책정하다
암시하다|언급하다|넌지시 말하다
혼합시키다|합동하다|융합하다
대기 |환경|주변의|분위기 |배경
무정형의|비결정질의|조직이 없는
일화
병합하다|부가물|합병하다
선조|전례|선행하는
기대하다|예상하다|예견하다
해독제|교정 수단|치료법
대조
변절자|배교자|탈당자
호소|매력|항소|마음에 들다|상고
…을 체포하다|이해하다|염려하다
통고하다|알리다|통지하다
승인하다|허가하다|찬성하다|동의하다|인정하다
대강의|가까운|흉내내다
임의의|독단적인|제멋대로의

체포하다|구속하다|검거하다|억류하다|저지하다
똑똑히 발음하다|체절 동물|음절로 나누다
책략|농간|기술
인공의|인위적인|인조의
주장하다|단언하다|강력히 주장하다
평가|결정|예측|검토|산정
근면한|부지런한|끈기 있는
가정하다|생각하다|추측하다|추정하다|맡다
증명하다|…을 입증하다|증언하다
특성|원인으로 여기다|…로 여기다|…에 따른|때문이라고 생각한다
피하다|회피하다|막다|방지|모면
장애|방해하다|방해
은인|후원자|은혜를 베푸는 사람
이로운|유익한|도움이 되는
수혜자|수익자|수취인
이익|혜택|도움이 되다
부진|시달리다|포위하다
포위하다|공격하다|쇄도하다
노예의 신분|속박|강제 노역
국경|경계|접해 있다|인접하다|가깝다
능력|가능성|재능
능력|용량|가능성|기능|자격
트집 잡는|책망하는|헐뜯는
…을 매혹하다|마음을 사로잡다|매혹시키다
잡다|포착|체포|캡처|담다
외우기 쉬운|귀를 끄는|재미있는|재치있는|대중적인
민첩함|민속|민첩
변화|바꾸다|변경|달라지다|전환하다
에두르는|완곡한|에움길의
원주|주변|외주
상황|환경|경우|사정|정황
우회하다|…을 포위하다|일주하다
서투른|눈치 없는|볼품없는
거친|상스러운
설득력|타당함|타당성
논리적인|일관성 있는|시종일관한
협력하다|공동으로 하다|협동하다
동료
집단적인|공동의|총괄적인|합쳐진
공모|결탁|음모
몰입|약속|헌신|책임|의지
상품|원자재|생필품
동요|소란|격렬한 움직임
통근자|정기권 통근자|교외 통근자
보상하다|보완하다
성분|구성 요소|부품|컴포넌트 |부분
행동하다|처신하다|어울리다
구성하다|작곡하다|만들다|쓰다|조직하다
화합물|복합의|합성물|혼합물|복잡하다
종합적인|포괄적인|광범위한
타협하다|절충하다|손상시키다|양보하다|노출시키다
의무적인|강제적인|필수의
인정하다|허용하다|굴복하다
자만|자부심
생각하다|임신하다|만들어지다|보다|구상
콘서트|공연|음악회|연주회|협주곡
동시 발생의|병발 사정|공동으로 작용하는
용서하다|눈감아주다|죄를 관대히 봐주다
수여하다|협의하다|상담하다
확인하다|확정하다|확신하다|확실히 하다
일치하다|따르다
혼잡하게 하다|가득차다|꽉 채우다
접속사|연대|관련|공동|동시 발생
보수적인|보수주의자|보존|우파|수수한
…을 보존하다|보호하다|절약하다
일관된|지속적인|일치하는|일리가 있는
통합하다|강화하다|공고해지다|튼튼해지다|굳히다
일정한|지속적인|끊임없는|계속되는|부단한
구성하다|간주하다|…에 해당하다|제정하다|나타내다
…을 압축하다|수축하다|…을 단단히 죄다
소비하다|먹어치우다|시간이 걸리다|…을 낭비하다|사로잡히다
전염성의|감염병 |파급
오염시키다|감염되다|중독시키다|더럽히다
경멸|모욕|무시
대회|콘테스트|경쟁하다|선거
인접하는|인접하고 있는|접근하는
조건으로 하는|파견단|분담액
계속해서|지속적으로|끊임없이|자꾸
윤곽|외형
반대의|정반대의|반하여|상반되는|모순된
위반하다|반대하다|위반 행위를 하다
기여하다|공헌하다|도움이 되다|원인|제공하다
논란의|문제의|논쟁의|갈등을 빚고 있는
소집하다|…을 소환하다|회합하다
편의|편리|편한|편익|용이함
전통적인|틀에 박힌|관습의
집중하다|…을 한 점에 모으다|모이다
대화하다|이야기하다|반대
전환하다|바꾸다|개조하다|개종하다|득점하다
협력하다|협조하다|협동하다
…에 반대로 작용하다|…을 방해하다|좌절시키다
…을 위조하다|위조의|가짜의
택배업자|배달원|전하는|운반인|심부름
공예|만들다|비행기|선박|솜씨
경련을 일으킨|비좁고 갑갑한|쥐가 난
억제하다|막다|감소|제한하다|제어
현재의|전류|현행의|지금의|해류
저주|욕설|재앙|비난|걱정
피상적인|겉핥기의|겉핥기식의
잔해|파편|쓰레기|폐기물|조각
감속하다|속도를 줄이다|속력을 늦추다
속이는|현혹시키는|남을 속이는
패배시키다|이기다|물리치다|무찌르다
결함|장애|탈주|이탈
연기하다|결정을 맡기다|경의를 표하다
부족|결함
솜씨 좋은|능숙한|날랜
죽은|현존하지 않는|멸종한
떨어뜨리다|비하|훼손|퇴화|악화
대표|대의원|위임하다|사절
비행의|의무 불이행의|비행 소년
전달하다|배달하다|전하다|구해내다|분만하다
기만적인|망상적인|믿을 수 없는
서거|사망|…을 양도하다
따라|의존하다|달리다|의지하다|좌우되다
추방하다|강제 이송하다|행동하다
폐|물러나다|퇴위시키다|면직하다|타도
유기된|버려진|직무 태만자
조소하다|…을 비웃다
사막|버리다|비우다|탈영하다|황무지
자격|만하다|마땅히|가치|싸다
빈곤한|가난한|결핍한
일관성 없는|산만한|종잡을 수 없는
단독의|분리하다|떼다|동떨어진|초연한
지체하게 하다|구류하다|붙들다
혐오하다|매우 싫어하다|몹시 싫어하다
손재주 있음|민첩함|능숙함
방언|지방 사투리|지방어
…을 구별하다|차별하다|차이가 생겨나다
지엽적인|주제를 벗어나기 쉬운|본론을 떠난
꾸물거리는|지체하는|더딘
해산하다|제대시키다|해체하다
방출하다|퇴원하다|제대하다|해고하다|이행하다
학문|규율|훈련|훈육|기강
…을 당황하게 하다|좌절시키다|패배
풀리다|…의 얽힘을 풀다|…을 해방하다
붕괴|분해|분열
일축하다|무시하다|해고하다|기각하다|각하하다
떨쳐버리다|불식|없애다|해소|풀다
나눠주다|조제하다|분배해주다|제공|나오다
처리|처분|폐기
폐기하다|처리하다|처분하다|없애다
성향|처분|기질|생각
녹이다|없애다|해산하다|해소하다
나눠주다|배포하다|분배하다|공급하다|기부하다
방해하다|혼란시키다|교란하다|어지럽히다|불안하게 하다
분기하는|벗어난|갈라지는
전환|다이버전|전용|주의 환기|벗어남
다양성|상이|변화
기부하다|기증하다
복용|1회분|약간의
노망하다|망령들다|맹목적으로 사랑하다
끌어내다|장애물|떨어뜨리다|계속되다|늑장부리다
철저한|맹렬한|격렬한
운전하다|구동하다|차로|드라이브|가다
내구력이 있는|튼튼한|오래 견디는
식|가리다|이클립스|에클리제|상쇄
영향|효과|발효|결과|현상
효율적인|효과적|능률적인|유능한
상세히 말하다|정교한|설명하다|정성들인|최선의
탄력 있는|신축성이 있는|고무줄|융통성이 있는
의기양양한|우쭐한|우쭐대는
선거의|선택 과목|선거로 임용되는
자격이 있는|권한이 있는|가능한
이해되지 않다|피하다|잘 피하다
발산하다|나오다|퍼지다
저명한|탁월한
방출하다|내뿜다|발산하다
경험적인|경험의|실증적인
제정하다|입법하다|시행하다|규정하다|만들다
…을 둘러싸다|…을 포함하다|포위하다
기부하다|…에게 부여하다|재산을 증여하다
견디다|지속하다|겪다|이기다|허락하다
수수께끼|암호
진취적인|적극적인
회피하다|피하다|면하다
결국|마침내|최종적으로|언젠가는
과장하다|지나친
넘어서다|초과하다|능가하다
전형적인|모범적인|본보기의
면제하다|면제된|면해주다
영향을 미치다|행사하다|압력을 가하다|노력하다
망명|추방|도피
터무니없는|과도한|엄청난
비싼|돈이 많이 드는|고가의|많은 비용|사치스러운
대표자|옹호자
노출하다|보이다|폭로하다|드러내다|경험하다
훈계|간언|충고
외향성인 사람|외향형|외향성의
위하다|촉진하다|활성화|용이|가능하게
시설|설비|재능
요인|원인|요소|유전자|인수
교수진|교직원|능력|학부
매료시키다|사로잡다|관심을 보이다|매혹시키다
빨리|빠른|단식하다|단식일|깊게
까다로운|성미가 까다로운|세심한 주의가 필요한
실행할 수 있는|실현 가능한|적당한
위업|공적|묘기
특징|출연하다|기능|특집|얼굴
비옥한|가임의|다산의
허구의|거짓의|가공의
꼭 맞는|부합|어울리는|건강한|착용
덧없는|어느덧 지나가는|무상한
선인|선조|선구자
몰수|벌금|상실하다
공식적인|정식의|형식적인|정규의|정장
광적인|열광한|열광적인
쉽게 지는|덧없는|휘발성의
도망자|도피자|탈주자|도주한
임신|잉태 기간|잠복기
점진적인|조금씩
중단|멈추다|막다|중지하다|마비
방해|저해|문제|지장|좌절
열심히|어려운|힘든|강경한|고생
가혹한|거친|강경한|냉엄한|거슬리는
쉰 목소리의|쉰|목이 쉰
수평의|가로의|바로 누운
가설|가정|추측
착각|환상|일루전|가상|망상
절박한|임박한|일촉즉발의
면역의|면제된|면역이 된
교착|난국|답보|대립|파행
재촉하다|억지로 …시키다|추진시키다
절박한|임박한|곧 일어날 듯한
미세한|근소한|감지될 수 없는
냉정한|침착한|쉽사리 동요하지 않는
충동적인|성급한|맹렬한
자극|기동력|힘
부과하다|제한하다|적용하다|강요하다|시행하다
비현실적인|비실용적인
난공불락의|확고한|수정 가능한
일어날 성싶지 않은|정말 같지 않은|불가능한
즉석에서|즉흥적으로|즉석의
충동|자극|원동력|욕망
활발하지 않은|활동하지 않는|소극적인
without knowledge or intention
…을 무능하게 하다|…을 실격시키다|능력을 빼앗다
uninterrupted in time and indefinitely long continuing
명백한|논쟁의 여지가 없는|논의할 여지없는
무관심한|무심한|냉담한|무관한|모르는 척
필수적인|불가결한|꼭 필요한
바람직한 효과가 없는|효력 없는|효험 없는
서투른|부적당한|부적절한
관성|타성|불활발
전염성의|감염성|병적인|중독성 강한
추론하다|추측하다|언급하다
메마른|불모의|생식력이 없는
약한|허약한|약해진
섭취하다|수집하다|받아들이다
재료|성분
초기의|원래의|1차|첫 글자|선도하는
새로운 계획|주도권|조치|이니셔티브|선제의
교활한|음흉한|방심할 수 없는
주장하다|고집하다|요구하다|강요하다
해결할 수 없는|용해되지 않는|녹지 않는
파산한|지급 불능의|파산의
순간적인|즉시적인|즉각적인
연구소|전문교육기관|대학교|협회|시행하다
손상되지 않은|온전한|원래대로의
완전한|필수의|전체
지적인|지식인|지성인|인텔리
중재하다|탄원하다|조정하다
간섭하다|방해하다|지장을 주다|침해하다|충돌하다
막간|사이에 생긴 일|막간 촌극
간헐적인|단속적인|일시적으로 멈추는
개입하다|끼어들다|사이에 있다
침략하다|침공|침입하다|침범|공격
불변의|불변식|변함없는
발명하다|개발하다|고안하다|창조하다
순회하는|순회자|편력자
일정|기행|여행|여정
노동|근로|노력|진통|출산
근면한|힘드는|어려운
지연|지체|…을 투옥하다
느슨한|로스엔젤레스 공항|태만한
도약하다|건너 뛰다|상승하다|발전하다|자살하다
임대하다|리스|임대 계약서|대여하다|민간자본유치사업
나머지|나머지의|찌꺼기
유산|업적|결과|여파|유물
의무|책임|부채
해방하다|자유롭게 하다|벗어나다
지속되다|남아 있다|서성대다|그림자를 드리우다
청산하다|정리하다|폐지하다
위치하다|찾아내다|자리잡고 있다|발견하다|위치를 찾다
이동|운동|이동력
익살맞은|바보 같은|웃음을 자아내게 하는
장엄|웅장|웅대
유지하다|계속하다|주장하다|관리하다|지속하다
임시변통의|임시변통의 물건|임시의
경기|어울리다|성냥|짝|조화되다
위협하다|위험|협박하다
변형|변태|변성
폭도|집단|군중
휴대전화|모바일|무선|활동적인|모빌
사회를 보다|온건한|적당한|중도의|완화하다
변경하다|변형하다|조절하다
순간|지금|때|잠깐|기회
일시적으로|곧|한때|잠정적으로
중요한|중대한|비상한
동기 부여|의욕|목적의식|자극하다|주도
움직이는|감동시키는|감동적인
변덕스러운|변하기 쉬운|가변성의
상호적인|서로의|공동의
길을 찾다|항해하다|돌아다니다|안내하다|잘 다루다
완고한|고집 센|고집이 센
사망의|사망 기사|부고
의무적인|필수의|강제적인
관찰하다|보다|지키다|준수하다|목격하다
완고한|고집센|고치기 힘든
직업|점령|일제 식민통치
발생하다|일어나다|생기다|나타나다|발견되다
비공식의|참견하기 좋아하는|주제넘게 나서는
…을 상쇄하다|벌충하다|상쇄하는 것
누락하다|제외하다|생략하다|…이 없는|빠지다
개시|시작|착수
반대의|상대|적|경쟁자
적절한|시의에 맞는|시기가 좋은
정반대의|상대|상반되는|맞은편의|서로 마주하는
선택하다|고르다|채택하다
궤도|돌다|안구
시대에 뒤진|지금은 쓸모없는|유행에 뒤진
현저한|뛰어난|눈에 띄는
명백한|만질 수 있는|촉진할 수 있는

경향|강한 기호|취미
연금|연기금|퇴직금|자산|펜션
인지하다|인식하다|…로 생각하다|인상을 주다
성능|성과|공연|수행|경기
형식적인|피상적인|겉치레의
위험한
썩기 쉬운|소멸하기 쉬운|영속하지 않는
영구적인|상설의|정규직의|영원한|파마
허가하다|허용하다|허락하다|용납하다
수직의|수직선|직립한
지속하는|끈기 있는|끊임없는
적절한|관계가 있는|부속물
혼란시키다|…을 당황하게 하다|교란하다
퍼지는|스며드는|골고루 미치는
심술궂은|사악한|기대에 어긋나는
휴대용의|이동식|포터블
연기하다|미루다|지연시키다|연장하다|늦추다
가정|…을 요구하다|…을 가정하다
자세|태세|배치하다|태도
실용적인|실용주의의|분주한
선례|앞서는|전례
교훈|격언|가르침
편애|좋아함|두둔
선호하다|좋아하다
전제|건물|토지|기본|선행조건
보존하다|보호하다|유지하다|지키다|보전하다
추정하다|가정하다|추측하다
주제넘은|뻔뻔스러운|건방진
막다|방지하다|예방하다|못하게 하다|금지하다
보호 관찰|집행 유예|시험
조사하다|수사하다|탐사하다|규명하다
성실|고결|청렴결백
진행하다|수익|계속하다|추진하다|나아가다
미루다| 끌다|연기하다
낭비하는|방탕한|풍부한
능숙한|숙달한|익숙한
수익성이 좋은|이익이 되는|이윤을 내는|돈벌이가 되는|도움이 되는
진보적인|진행하는|점진적인|진보주의의
증식하다|번식하다|급증하다
유명한|두드러진|뛰어난|탁월한|실력 있는
홍보하다|증진하다|촉진하다|활성화시키다|장려하다
촉발하다|신속한|촉구하다
경향|성향|기호
근접|근친|가까움
제안자|지지자|발의자
제안|명제|프로포지션|주장
예의 바름|적당|타당
시위|항의|반대하다|저항|데모
원형|시제품|모델|견본|기본형
기원|출처|유래
근접|가까움|접근
취지|의도|칭하다
목적|목표|용도|의도|명분
범위|이르다|영역|사거리|산맥
황폐|파괴|…을 약탈하다
멀어지다|감소하다
감수성이 풍부한|잘 받아들이는|수용하는
휴회|휴식|쉬다|휴정|휴가
이식자|받는|수금자|수상자|수혜자
기억|회상
의지|맡기다|소송|청구|수단
회복하다|되찾다|건강을 되찾게 하다
순환하는|거듭 발생하는|되풀이되는
만회하다|교환|구하다|보상|상환하다
말하다|언급하다|부르다|가리키다|뜻하다
국민투표|주민투표|선거
퇴화|복귀|회귀
상환하다|배상하다|변상하다
되풀이하다|다시 행하다|장황하고 지루하게 반복하다
관련시키다|관계시키다|연관되다|연결되다
발표하다|개봉하다|공개하다|발매하다|출시하다
좌천시키다|…을 내려앉히다|이관하다
신뢰할 만한|믿을 만한|신빙성 있는|믿음직한
포기하다|양도하다|그만두다
태만한|부주의한|무기력한
송금하다|면제하다|보내다
나머지|자투리|유물
원격의|외딴|먼|리모컨|희박한
보상|보수|급료
되게 하다|표현하다|제공하다
폐지|폐지하다|무효로 하다
쫓아버리다|격퇴하다|물리치다
대체하다|교체하다|대신하다|바꾸다|후임으로 임명되다
괘씸한|비난받을 만한|비난받아야 할
꾸짖다|비난하다|책망하다
보유하다|보호지역|예비|준비의|매장량
잔류물|남아있는|잔존|잔여|찌꺼기
회복력|탄성|끈질긴|튼튼한|강력한
내성|저항|강한|견디는|방지
결의|해상도|해결|결심|결정
해결하다|결의하다|대책을 마련하다|해법
리조트|의존하다|휴양지|수단
반항적인|차분하지 못한|침애하지 못한
제한하다|자제하다|검거하다|금지하다|압박하다
제한하다|규제|금지하다|제약|통제
재개하다|다시 시작하다|이력서|경력|되찾다
유지하다|보유하다|가지다|계속하다|남겨두다
…을 늦추다|방해하다|지연
응보|보복|징벌
매출|수입|수익|세입|순이익
반대의|뒤집다|바꾸다|되돌리다|파기하다
되돌아가다|복귀하다|회고하다
격변|혐오|반감
말도 안 되는|터무니없는|우스꽝스러운|우스운|어리석은
엄격한|혹독한|철저한|엄밀한|정밀한
현저한|두드러진|돌출부
재앙|사회악|끔찍한 |해악|채찍질하다
탈퇴하다|탈당하다
진정제|진정시키는
앉아서 하는|앉아 있는|앉은 자세의
침전물|앙금|퇴적물
제공하다|복무하다|봉사하다|근무하다|대접하다
예속|노예 상태|징역
좌절|실패|역행
해결하다|정착하다|타협을 보다|진정시키다|결정하다
족쇄|쇠고랑|갇히다|사슬|잡다
변화|전환|이동하다|바뀌다|옮기다
게으름|여유|바지|해이해져|되는대로의
나무늘보|나태|게으름
단정치 못한|되는대로|되는대로의
느린|부진한|게으른
응고하다|굳어지다|응고시키다
속도위반|과속|고속 진행
…을 결혼시키다|꼬아 잇다|꼬아 잇기
안정적인|마구간|외양간|견실한
지분|걸다|말뚝|제공하다
딱딱해진|상한|진부한|김빠진
…을 수가 막히게 하다|스테일메이트|막다른 궁지
주요한|주요 산물|기본 식품
균형 상태|「정지」 「안정 상태」의 뜻|울혈
국가|상태|주|정부|…을 분명히 말하다
정거장|역|방송국|기지|주둔하다
신장|키|성장|위업
상태|지위|신분|현상|사정
법령|법규|성문법
확고한|고수하다|확고부동한|불변의
줄기|기인하다|따른|비롯되다|생기다
진부한|판에 박은|틀에 박힌
막대기|붙다|고수하다|갇히다|찌르다
변형|종류|긴장|균주|피로
전략|계략|책략
격렬한|분투적인|활기찬
엄격한|강력한|철저한|엄중한|지나친
줄|현악|일련|조건|묶다
엄격한|강화|엄중한|까다로운|엄한
제출하다|제시하다|복종하다|굴복하다
가라앉다|침묵하다|진정되다
원조하다|후원하다|보조해주다
존재하다|살아가다|존속하다
상당한|실질적인|중대한|현저한|튼튼한
…을 구체화하다|…을 확증하다|입증하다
대체하다|대신|대용하다|대리|대안
핑계|구실|기피
전복시키는|파괴하는|파괴적인
성공하다|뒤를 잇다|후임이 되다|계속되다|대신하다
간결한|간명한|말의 간결성이 특징인
겪다|고통을 받다|앓다|입다|고생하다
충분한|만족스러운
사치스러운|값비싼|호화로운
피상적인|겉으로 드러나는|외부의|천박한
대체하다|대신하다|교체하다|자리를 바꾸다
미신
대체하다|대신하다|대신 들어앉다
지원하다|지지하다|뒷받침하다|돕다|유지하다
가정|상상|추정
과도|과식|폭식
추측하다|추측|짐작
넘어서다|앞서다|돌파하다|초과하다|극복하다
항복하다|포기하다|인도하다|자수하다|몸을 맡기다
비밀의|뒤가 구린|몰래 하는
영향을 받기 쉬운|민감한|감염되기 쉬운
중단하다|정지하다|…을 연기하다|달다|지연되다
지속하다|부상을 입다|지탱하다|견디다|지지하다
종합|통합|합성
재치 있는|약삭빠른|적절한
전술|전략|방법|작전|정책
촉각의|촉각으로 알 수 있는|촉지할 수 있는
유형의|만져서 알 수 있는|명백한
느린|지각한|늦은
유혹하다|하고 싶은|끌다|꾀다
지지할 수 있는|공격에 견디는|방어할 수 있는
집요한|끈질긴|고집하는
주의|교의|견해
증언하다|표명하다|증명하다
논문|주제
참다|견디다|내성이 있다
과민한|다루기 어려운|타기 쉬운
거래|트랜잭션|계약|업무|입출금
넘겨주다|옮기다|갈아타다|바꾸다|물려주다
어기다|위반하다|넘다
덧없는|일시적인|잠깐 머무르는
일시적인|덧없는|오래가지 않는
교통|운송|이동 수단
횡단하다|가로지르다|횡단
침입하다|침해하다|죄를 범하다|폐를 끼치다
탁한|자욱한|혼란된
사나운|폭풍우의|험한
소란|혼란|소동
…을 대표하다|…의 특징을 나타내다|…의 전형이 되다
주제넘지 않는|젠체하지 않는|겸손한
말굴레를 매지 않은|억제되지 않은|구속이 없는
유니폼|똑같은|일제히
전례 없는|유례없는|엄청난|이례적
풀다|…을 해명하다|해결하다
화난|기분 나쁜|당황|혼란|아픈
긴급한|급박한|긴박한|절박한|다급한
다양|여러종류|여러 가지|버라이어티|갖가지
…의 방향을 바꾸다|바뀌다|방향이 바뀌다
속도
배출구|분출하다|분노|분화구|화풀이
가장자리|경계|변두리
다재 다능한|다용도의|다목적|다양한|다기능
숙달한|정통한|reversed
거꾸로|반대로|반대의 경우도 마찬가지
주변|인근|가까이
변천|변화|부침
큰 소리로 외치는|떠들썩한|시끄러운
수확|항복|수율|수익|수익률
완화시키다|누그러지다|약해지다|덜해지다|줄이다
줄이다|줄여 쓰다|요약하다
비열한|비참한|천한
폐지하다|없애다|철폐하다
연마재|벗겨지는|쓸리는
요약하다|단축하다|줄이다
폐기하다|폐지하다|무효화하다
갑자기|돌연히|예고없이|불쑥|손 쓸 틈도 없이
종적을 감추다|몰래 도망치다|몰래 도주하다
흡수하다|열중하다|받아들이다|빼앗다|빨아들이다
난해한|심오한
풍부한|많은|과잉
호평|찬사|갈채하다|환호
공범
풍부한 광맥|대풍년|노다지
위반|침해|어기다|무너지다|누출
돌파|획기적인|발전|중요한|해결
짧음|간결함|간결성
부서지기 쉬운|덧없는|깨지기 쉬운
깼다|부서졌다|파산한|무일푼의|빈털터리의
굴을 파다|굴에 살다|숨다|은신처
위장|카무플라주|감추다|분식
보살피다|마음쓰다|관리하다|돌보다|상관하다
배역|주조|투표하다|던지다|드리우다
큰 동굴|…을 가두다|공동
소중히 여기다|고이 간직하다|기리다
…을 제한하다|주위에 경계선을 긋다|…의 주위에 선을 긋다
신중한|조심성있는|용의 주도한
예로 들다|말하다|소환하다
주장하다|말하다|요구하다|차지하다|제기하다
떠들어대다|아우성|떠들썩함
비밀의|은밀한|비밀히 행해지는
명백히하다|분명해지다|밝히다|명확하게
분명해지다|분명한|밝아지다|명확하다|확실히
고객|클라이언트|의뢰인|거래처|민원인
회유자|조정자|달래는 사람
간결한|간명한|명료한
결정적인|단호한|결정적인 종국적인
고백하다|자백하다|인정하다|시인하다|실토하다
갈등|분쟁|대립|전쟁
혼란스럽다|혼동하다|당황하게 하다|어리둥절하게 하다
대기업|재벌|그룹|집단|역암
추측하다|문제|해독
정복하다|차지하다|등정하다|극복하다
징집된|징집하다|징집병
위탁하다|맡기다|탁송하다
과시적|눈에 띄는|두드러지는
건설적인
해석하다|문법적으로 설명되다|구문 분석
다투기 좋아하는|논쟁을 좋아하는|이론의 여지가 있는
만족|흡족해함
모순되다|다르다|부정하다|반박하다
뉘우치는|죄를 깊이 뉘우치는|통한의
설득하다|확신시키다|납득시키다
부수다|크럼블|가루가 되다
비밀의|숨은|몸을 숨기기에 알맞은
성가신|다루기 힘든|다루기 어려운
궁금한|알고 싶은|이상한|신기한|호기심이 강한
단축하다|삭감하다|줄이다
구속|구금|수감|양육권|보호관리
식기|식칼|날붙이
최첨단|첨단
제왕절개, 제왕절개술
다트|쏘다|꼬챙이|쏘아보다
부족|결핍|기근
논의의 여지가 있는|미해결의|논쟁할 수 있는
선언하다|말하다|주장|선고하다|신고하다
감소하다|줄다|하락하다|거절하다|쇠퇴하다
헌신하다|바치다|…을 위한|전념하다|전용의
…을 중상하다|비방하다|…의 면목을 잃게 하다
방어하다|지키다|옹호하다|보호하다|변호하다
빗나가다|비끼게하다|비끼다
완화시키다|신관을 제거하다|진정시키다
…의 기를 꺾다|낙담시키다|…을 풀죽게 하다
삭제하다|지우다|없애다|제거하다
해로운|유독한|해독을 끼치는
쇄도|대홍수|엄청나다|붓다|범람
철거하다|파괴하다|허물다|무너지다|없애다
증명하다|입증하다|시위하다|나타내다|설명하다
호칭|명명|단위
비난하다|비판하다|반대하다|매도하다|파기하다
배치하다|전개하다|알맞게 사용하다
실망시키다|낙담시키다|기대에 어긋나다|망치다
…의 책임을 부정하다|…과의 관계를 부인하다|…을 거부하다
식별하다|분간하다|알아차리다
거부하다|부인하다|청구권을 포기하다
신중한|분별력 있는|사려깊은
위장|변장|가장하다|숨기다|사칭
실격시키다|자격을 박탈하다|부적격으로 간주하다
무시하다|외면하다
방해하다|피해를 주다|혼란에 빠뜨리다|중단시키다|붕괴시키다
해부하다|분석하다|절단하다
흩뜨리다|…을 낭비하다|탕진하다
팽창시키다|부풀다|넓히다
저명한|뛰어난|차별화된|뚜렷한|품위 있는
잘못 전해진|왜곡한|정신적으로 비뚤어진
배당금|나뉨수|피제수
흠뻑 젖음|…을 흠뻑 적시다|…을 담그다
고된 일|고역|천한 일
지루한|따분한|둔한|침체한|무딘
중복되다|복제한|같은 |복사하다|이중
귀표|귀표를 하다|배당하다
개화|발진|풍해
배설하다|내쫓다|…을 홱 하고 꺼내다
웅변|달변|웅변술
상징|문장|기장
떠오르다|새로운|나타나다|(어려움에서) 벗어나다|명백해지다
강조하다|힘주어 말하다|중요시하다|역설하다
정규직|고용하다|자영업자|이용하다|사용하다
명백한|노골적인|솔직한
활용하다|착취하다|업적|묘기
정교한|절묘한
확장하다|연장하다|늘리다|미치다|뻗다
확장|연장|확대|연기|내선번호
광범위한|대규모의|넓은|방대한|포괄적
멸종한|사라진
진화하다|끄다|소멸시키다
강탈하다|강요하다|빼앗다
동화|꾸며낸 이야기
공정한|공평한|박람회|전시회|타당한
기근|기아|굶주림
사망자|숙명|치사성
부탁|선호하다|주다|찬성하다|호의
좋아하는|마음에 드는|인기 있는|우승 후보
…인 체하다|가장하다|꾸며대다
부양하다|방어하다|꾸려가다
유연한|신축성 있는|탄력적인|융통성 있는|적응성 있는
약한|얇은|가는|뻔한|허술한
번창하다|활약하다|성장하다|무성하다
변동하다|등락하다|움직이다|요동하다|변하다
물을 내리다|붉어지다|내보내다
화석|시대에 뒤진 사람
싸움|소동|야단법석
일부|적은|분수|파편
골절|파괴|균열|파쇄하다|손상
취약한|깨지기 쉬운|부진한|쉽게 영향을 받는
파편|분열하다|무리
허약한|빈약한
검소한|절약하는|간소한
은밀한|몰래 하는|교활한
헛된|헛수고|무산|시시한
수다스러운|장황한|잘 지껄이는
보석|보물
파악하다|격투하다|잡아거는 갈고리
연삭|갈다|분쇄 |연마|멈추다
옥신각신|입씨름|흥정하다
품질 증명|특징|우량 마크
혼란|파괴|피해|재앙|황폐
한창때|전성기|어머나
중단|틈|모음 접속
끔찍한|가증스러운
매기|걸기|…을 결혼시키다
훅하다|빠지다|갈고리|바늘
던지다|퍼붓다|토하다|영향력을 행사하다|타격을 주다
비밀에 부치다|입다물어|정적|쉿
정신없는|열심히|번잡한|밀매
과장|과장법|과장적 서술
고혈압|과도의 긴장|고혈압증
문맹
담그다|…에게 침례를 베풀다
주다|알리다|전하다
공정한|공평한|치우치지 않는
연루시키다|관련되다|혐의|포함하다|유죄
암시하다|함축하다
가난해진|빈곤에 빠진|힘을 빼앗긴
감수성이 예민한|민감한|영향받기 쉬운
피할수없는|냉혹한|엄연한|가혹한|무서운
악명 높은|지독한|매우 평판이 나쁜
…을 침투시키다|스며들다|잠입하다
유입|쇄도|도래
위반|불완전 골절|침해
침해하다|어기다|위반하다
우리다|우러나다|달이다
탐구적인|쓱 살펴보는|물어보는|호기심이 많은
쓰다|적다|새기다
통찰력|보여줌|이해|식견
무의미|하찮음|사소함
넌지시 비치다|빗대어 말하다|암시하다
검사하다|조사하다|면밀하게 살피다
선동하다|부추기다|유발시키다|일으키다|충동하다
본능적인|직관적인|자연|무의식적인|반사적인
악기|도구|기구
강렬한|심한|집중적인|거센
의도|의향|열중하는|고의로
…을 던져넣다|불쑥 끼워 넣다|말참견하다
심문하다|…에게 질문하다|…을 따져 묻다
방해하다|중단하다|끼어들다|끊다|가로막다
내성적인|자기 반성의|내성의
침범하다|방해하다|개입하다|강제하다
잠재성의|잠복성의|숨어 있는
아낌없이 주다|낭비하는|사치스러운
읽기 쉬운|판독할 수 있는|읽을 수 있는
길이|기간|거리|세로
언어학자|수개 국어에 능통한 사람|부족 수장의 대변자
읽고 쓰는 능력|읽고 쓸 줄 앎|교양이 있음
글자 그대로의|문자의
장수|수명|장명
시끄러운|떠들썩한|말하기를 좋아하는
저주|중상|욕
맨틀|외벽|망토
문서|원고|손으로 쓴
거칠게 다루다|큰 망치|…을 난폭하게 다루다
통합하다|합병하다|합쳐지다
신진대사|물질 대사|대사
현미경
이정표|기록|획기적인 사건|단계|기념비
인색한|욕심 많은|수전노인
단일 언어의|한 언어를 사용한|한 언어 사용자
획일적이고 자유가 없는|단일체의|모놀리스로 만든
한 입|소량|조금
근시의|근시안의|근시안적인
사악한|극악한|흉악한
틈새 시장|틈새|지위|니치|분야
지명하다|후보에 오르다|추천하다|임명하다
초당파의|무소속의|객관적인
순종하는|공손한|얌전한
물건|객체|것|대상|목적
비스듬한|사선의|사격의
지우다|…을 제거하다|…의 흔적을 없애다
방해하다|가로막다|침해하다
강요하다|주제넘게 나서다|불쑥 내밀다
분명한|명백한|뻔한|확실한
숨은|신비한|초자연적인
눈의|접안경|눈과 같은
냄새나는
기분이 상하다|불쾌하게 하다|성나게 하다|위반하다|해치다
새다|스며 나오다|분비
억압하다|탄압하다|억누르다
부유한|호화로운|풍부한
웅변가|연설자|변사
표면상의|겉보기만의|표면만의
간과|실수|감독
우화|비유|비유하여 이야기하다
인색|절약|지나치게 검소함
참여하다|참가하다|참석하다|출전하다|동참하다
관통하다|파고들다|침투하다|발견하다|넘어서다
가난한|인색한|몹시 인색한
…에 삼투하다|여과하다|거르다
천공|관통|구멍을 냄
그럴듯한|정말 같은|외양만 좋은
휘기 쉬운|유연한|플라이어블
감소하다|떨어지다|급락하다|추락하다|빠져들다
날카로움|매서움|통렬함
점|지적하다|포인트|요점|시점
표적을 겨냥한, 직접적인
오염시키다|분위기를 흐리다
전조|조짐|경이적인 존재
불확실한|위험한|위태로운
정밀한|정확한
…을 방해하다|막다|…을 배제하다
곤경|곤란함|어려움
단정하다
아직 기록을 남기지 않은|문자를 모르는 사람|문자 사용 이전의
특권|특전|대권
처방
누르기|긴급한|시급한|절박한|집요한
명문|명망|권위|유명한|일류의
~척하다|가장하다|흉내내다|가짜의|속이다
허세부리는|자부하는|자만하는
약삭빠른|영리한|빈틈없는|현명한|능수능란한
왜곡하다|비스듬하게 되다|빗나가다
대충 읽어보다|걷어내다
작은 접전|소전투|작은 접전을 벌이다
때리다|치다|기미|냄새|강타하다
젖다|흡수하다|담그다|빨아들이다|절이다
냉정한|술이 깨다|술을 끊다|취하지 않은
요청|요구|부탁하다|도움|구하다
독백|혼잣말|혼자말
전문화하다|특수화하다|전공하다
특정한|구체적인|특별한|정확히|상세한
표본|견본
그럴 듯한|허울 좋은|겉만 번드르르한
장관의|화려한|멋진|극적인|환상적인
스펙트럼|범위|잔상
추측하다|분석하다|예상하다|짐작하다|내다보다
망치다|상하다|버릇없는|전리품|스포일러
배우자
박차|자극|충동
구제하다|치료하다|요법|처방하다
후회|반성|가책|참회|회한
일으키다|젓다|자극하다|동요시키다|섞다
파업 중인|두드러진|공격의|놀랄만한|타격의
뇌졸중|스트로크|타|발작|붓놀림
과목|주제|대상|주어|국민
잠수하다|담그다|…을 물속에 넣다
가입하다|구독하다|찬성하다
굴복하다|죽다|양보하다
참정권|투표|선거권
여분의|불필요한|과잉의
감독|관리|지휘|감시
탄원하다|간청하다|애원하다
억제하다|억압하다|진압하다|감추다
감시|사찰|추적|정찰|도청
조사하다|연구하다|평가하다
의심하다|용의자|생각하다|피의자|혐의를 받은
무언의|암묵의|잠잠한
간섭하다|메워 넣는 막대|주무르다
지루한|장황한
망원경|현미경|압축하다
성격|화
기질의|신경질적인|변덕스러운|까다로운
축어적으로|말대로|정확히 말 그대로
말 수가 많은|말이 많은|장황한
의복을 입다|조끼|셔츠
방심하지 않는|경계하고 있는|방심않는
…의 정당성을 입증하다|…을 변호하다|비난을 풀다
전망|경치|비스타
가창의|목소리의|목의|시끄러운|드러내다
보증하다|단언하다|인용하다
암호|군호|표어
백색 도료|회반죽|…에 백색 도료를 바르다
말다툼하다|논쟁하다|논쟁
익숙한